{
    "width": 10,
    "height": 3,
    "tileTypes": {
        "OPEN": 0
    },
    "layers": [
        {
            "width": 10,
            "height": 10,
            "tileWidth": 16,
            "tileHeight": 16,
            "img": "/img/tiles.png",
            "atlas": [
                [0, 0, 0],
                [16, 0, 0],
                [32, 0, 0]
            ],
            "tiles": [
                1, 1, 1, 1, 1, 1, 1, 1, 1, 1,
                1, 0, 2, 0, 2, 0, 2, 0, 2, 1,
                1, 2, 0, 2, 0, 2, 0, 2, 0, 1,
                1, 0, 2, 0, 2, 0, 2, 0, 2, 1,
                1, 2, 0, 2, 0, 2, 0, 2, 0, 1,
                1, 0, 2, 0, 2, 0, 2, 0, 2, 1,
                1, 2, 0, 2, 0, 2, 0, 2, 0, 1,
                1, 0, 2, 0, 2, 0, 2, 0, 2, 1,
                1, 2, 0, 2, 0, 2, 0, 2, 0, 1,
                1, 1, 1, 1, 1, 1, 1, 1, 1, 1
            ]
        }
    ]
}
